0 0 0 0 0 0 0 0 0 0 0 0 0 0 0 0 0 0 0 0
0 0 0 0 0 0 0 0 0 0 0 0 0 0 0 0 0 0 0 0
0 0 0 0 0 0 0 0 0 0 0 0 0 0 0 0 0 0 0 0
0 0 0 0 0 0 6 6 6 6 6 6 6 6 0 0 0 0 0 0
0 0 0 0 0 6 4 4 4 4 4 4 4 4 6 0 0 0 0 0
0 0 0 0 6 4 4 5 5 5 5 5 5 4 4 6 6 6 6 6
0 0 0 0 6 4 5 5 5 5 5 5 5 5 4 4 4 4 4 4
0 0 0 0 6 4 5 5 5 5 5 5 5 5 4 4 4 4 4 4
0 0 0 0 6 4 5 5 5 5 5 5 5 5 4 4 4 4 4 4
0 0 0 0 6 4 4 5 5 5 5 5 5 4 4 6 6 6 6 6
0 0 0 0 0 6 4 4 4 4 4 4 4 4 6 0 0 0 0 0
0 0 0 0 0 0 6 6 6 6 6 6 6 6 0 0 0 0 0 0
0 0 0 0 0 0 0 0 0 0 0 0 0 0 0 0 0 0 0 0
0 0 0 0 0 0 0 0 0 0 0 0 0 0 0 0 0 0 0 0
0 0 0 0 0 0 0 0 0 0 0 0 0 0 0 0 0 0 0 0

