1 0 
1
0 1
6 6 6 6 6 6 6 6 6 6 6 6 6 6 6 6 6 6 6 6
6 4 4 4 4 4 4 4 4 4 4 4 4 4 4 4 4 4 4 6
6 4 4 6 6 6 6 4 4 4 4 4 4 4 4 4 4 4 4 6
6 4 4 4 4 4 4 4 4 4 4 4 4 4 4 4 4 4 4 6
6 4 4 4 4 4 4 4 4 4 4 4 4 4 4 4 4 4 4 6
6 4 4 4 6 6 6 6 4 4 4 4 4 4 4 4 4 4 4 4
6 4 4 4 4 4 4 4 4 4 4 4 4 4 4 4 4 4 4 4
6 4 4 4 6 6 6 6 4 6 4 4 4 4 4 4 4 4 4 4
6 4 4 4 4 4 6 6 4 6 4 4 4 4 4 4 4 4 4 6
6 4 4 4 4 6 4 6 4 6 4 4 4 4 4 4 4 4 4 6
6 4 4 4 4 4 4 6 4 6 4 4 4 4 4 4 4 4 4 6
6 4 4 4 4 4 4 4 4 4 4 4 4 4 4 4 4 4 4 6
6 4 4 4 4 4 4 4 4 4 4 4 4 4 4 4 4 4 4 6
6 4 4 4 4 4 4 4 4 4 4 4 4 4 4 4 4 4 4 6
6 6 6 6 6 6 6 6 6 6 6 6 6 6 6 6 6 6 6 6