1 1
1
1 0
6 6 6 6 6 6 6 6 6 6 6 6 6 6 6 6 6 6 6 6
6 4 4 4 4 4 4 4 4 4 4 4 4 4 4 4 4 4 4 6
6 4 4 6 6 6 6 4 4 4 4 4 4 4 4 4 4 4 4 6
6 4 4 4 4 4 4 4 4 4 4 4 4 4 4 4 4 4 4 6
6 4 4 4 4 4 4 4 4 4 4 4 4 4 4 4 4 4 4 6
4 4 4 4 6 6 6 6 4 4 4 4 4 4 4 4 4 4 4 6
4 4 4 4 4 4 4 4 4 4 4 4 4 4 4 4 4 4 4 6
4 4 4 4 6 6 6 6 4 6 4 4 4 4 4 4 4 4 4 6
6 4 4 4 4 4 6 6 4 6 4 4 4 4 4 4 4 4 4 6
6 4 4 4 4 6 4 6 4 6 4 4 4 4 4 4 4 4 4 6
6 4 4 4 4 4 4 6 4 6 4 4 4 4 4 4 4 4 4 6
6 4 4 4 4 4 4 4 4 4 4 4 4 4 4 4 4 4 4 6
6 4 4 4 4 4 4 4 4 4 4 4 4 4 4 4 4 4 4 6
6 4 4 4 4 4 4 4 4 4 4 4 4 4 4 4 4 4 4 6
6 6 6 6 6 6 6 6 6 6 6 6 6 6 6 6 6 6 6 6