1 3
1
1 2
6 6 6 6 6 6 6 6 6 6 6 6 6 6 6 6 6 6 6 6
6 4 4 4 4 4 4 4 4 4 4 4 4 4 4 4 4 4 4 6
6 4 4 6 6 6 6 4 4 4 4 4 4 4 4 4 4 4 4 6
6 4 4 4 4 4 4 4 4 4 4 4 4 4 4 4 4 4 4 6
6 4 4 4 4 4 4 4 4 4 4 4 4 4 4 4 4 4 4 6
6 4 4 4 6 6 6 6 4 4 4 4 4 4 4 4 4 4 4 6
4 4 4 4 4 4 4 4 4 4 4 4 4 4 4 4 4 4 4 6
4 4 4 4 4 4 4 4 4 4 4 4 4 4 4 4 4 4 4 6
4 4 4 4 4 4 6 6 4 4 4 4 4 4 4 4 4 4 4 6
6 4 4 4 4 6 4 6 4 4 4 4 4 4 4 4 4 4 4 6
6 4 4 4 4 4 4 6 4 4 4 4 4 4 4 4 4 4 4 6
6 4 4 4 4 4 4 4 4 4 4 4 4 4 4 4 4 4 4 6
6 4 4 4 4 4 4 4 4 4 4 4 4 4 4 4 4 4 4 6
6 4 4 4 4 4 4 4 4 4 4 4 4 4 4 4 4 4 4 6
6 6 6 6 6 6 6 6 6 6 6 6 6 6 6 6 6 6 6 6